0000000000000000000
0000000000000222200
0000000000000000000
00000000000000000002222222222
0000000222220000000
0000000000000000000
2200000000000000022
1122222222222222211
1111111111111111111
1111111111111111111
1111111111111111111
1111111111111111111
1111111111111111111
1111111111111111111